⠀⠀⠀⠀⠀⠀⠀⠀⠀⠀⠀⠀⠀⠀⠀⠀⠀⠀⠀⠀⠀⠀⠀⠀⠀⠀⠀⠀⠀⠀⠀⠀⠀⣀⣤⣶⡶⠿⠿⠿⠿⠿⠿⠷⣶⣦⣄⡀⠀⠀⠀⠀⠀⠀⠀⠀⠀⠀⠀⠀⠀⠀⠀⠀⠀
⠀⠀⠀⠀⠀⠀⠀⠀⠀⠀⠀⠀⠀⠀⠀⠀⠀⠀⠀⠀⠀⠀⠀⠀⠀⠀⠀⠀⠀⠀⢀⣴⡿⠛⠉⠀⠀⠀⠀⠀⠀⠀⠀⠀⠀⠈⠙⠿⣷⣄⠀⠀⠀⠀⠀⠀⠀⠀⠀⠀⠀⠀⠀⠀⠀
⠀⠀⠀⠀⠀⠀⠀⠀⠀⠀⠀⠀⠀⠀⠀⠀⠀⠀⠀⠀⠀⠀⠀⠀⠀⠀⠀⠀⠀⣴⡿⠋⠀⠀⠀⠀⠀⠀⠀⠀⠀⠀⠀⠀⠀⠀⠀⠀⠘⢿⣦⠀⠀⠀⠀⠀⠀⠀⠀⠀⠀⠀⠀⠀⠀
⠀⠀⠀⠀⠀⠀⠀⠀⠀⠀⠀⠀⠀⠀⠀⠀⠀⠀⠀⠀⠀⠀⠀⠀⠀⠀⠀⠀⣾⡟⠀⠀⠀⠀⣴⢳⠀⠀⠀⠀⠀⡞⣦⠀⠀⠀⠀⠀⢸⠏⢿⣷⠀⠀⠀⠀⠀⠀⠀⠀⠀⠀⠀⠀⠀
⠀⠀⠀⠀⠀⠀⠀⠀⠀⠀⠀⠀⠀⠀⠀⠀⠀⠀⠀⠀⠀⠀⠀⠀⠀⠀⠀⣼⡟⠀⠀⠀⠀⠀⣿⣿⠀⠀⠀⠀⠀⣿⣿⠀⠀⠀⠀⠀⢸⠀⠈⣿⣇⠀⠀⠀⠀⠀⠀⠀⠀⠀⠀⠀⠀
⠀⠀⠀⠀⠀⠀⠀⠀⠀⠀⠀⠀⠀⠀⠀⠀⠀⠀⠀⠀⠀⠀⠀⠀⠀⠀⢠⣿⠁⠀⠀⠀⠀⠀⠿⡿⠀⣀⡀⠀⠀⠿⠏⠀⠀⠀⠀⠀⡞⠀⠀⠸⣿⠀⠀⠀⠀⠀⠀⠀⠀⠀⠀⠀⠀
⠀⠀⠀⠀⠀⠀⠀⠀⠀⠀⠀⠀⠀⠀⠀⠀⠀⠀⠀⠀⠀⠀⠀⠀⠀⠀⢸⣿⠀⠀⠀⠀⠀⢀⣴⣿⠛⢻⡙⠛⠻⢷⣄⠀⠀⠀⠀⢰⠇⠀⠀⠀⣿⡆⠀⠀⠀⠀⠀⠀⠀⠀⠀⠀⠀
⠀⠀⠀⠀⠀⠀⠀⠀⠀⠀⠀⠀⠀⣠⣤⣶⠾⠿⠛⠛⠛⠛⠿⠿⣶⣤⣼⣿⠀⠀⠀⠀⠀⠸⣧⡉⠒⠊⠀⠀⠀⣨⣿⡆⠀⠀⠀⡸⠀⠀⠀⠀⣿⡇⠀⠀⠀⠀⠀⠀⠀⠀⠀⠀⠀
⠀⠀⠀⠀⠀⠀⠀⠀⠀⠀⢀⣴⡿⠛⠁⠀⠀⠀⠀⠀⠀⠀⠀⠀⠀⠉⠻⢿⣦⠀⠀⠀⠀⠀⠙⠻⠷⣶⡶⠶⠿⣛⠽⠃⠀⠀⢠⠇⠀⠀⠀⠀⣿⡇⠀⠀⠀⠀⠀⠀⠀⠀⠀⠀⠀
⠀⠀⠀⠀⠀⠀⠀⠀⠀⣰⡿⠋⠀⠀⠀⠀⠀⠀⠀⠀⠀⠀⠀⠀⠀⠀⠀⢀⡿⣷⡄⠀⠀⠀⠀⠀⠀⠈⠁⠀⠀⠀⠀⠀⠀⢀⡎⠀⠀⠀⠀⠀⣿⡇⠀⠀⠀⠀⠀⠀⠀⠀⠀⠀⠀
⠀⠀⠀⠀⠀⠀⠀⠀⣴⡿⠁⠀⠀⠀⢀⣀⠀⠀⠀⠀⠀⣀⡀⠀⠀⠀⠀⣼⠀⠙⣿⡄⠀⠀⠀⠀⠀⠀⠀⠀⠀⠀⠀⠀⢠⠎⠀⠀⠀⠀⠀⠀⣿⠇⠀⠀⠀⠀⠀⠀⠀⠀⠀⠀⠀
⠀⠀⠀⠀⠀⠀⠀⢰⣿⠁⠀⠀⠀⠀⣿⣼⡆⠀⠀⠀⢸⣧⡇⠀⠀⠀⠀⡏⠀⠀⢹⣿⠀⠀⠀⠀⠀⠀⠀⠀⠀⢀⣀⣴⣃⠀⠀⠀⠀⠀⠀⠀⣿⠁⠀⠀⠀⠀⠀⠀⠀⠀⠀⠀⠀
⠀⠀⠀⠀⠀⠀⠀⣾⡏⠀⠀⠀⠀⠀⣿⣿⠀⠀⠀⠀⢸⣿⡇⠀⠀⠀⠀⡇⠀⠀⠀⣿⡆⠀⠀⢀⣠⣴⡾⠟⠛⠛⠋⠙⠛⠛⠻⠿⣶⣤⣄⢰⣿⠀⠀⠀⠀⠀⠀⠀⠀⠀⠀⠀⠀
⠀⠀⠀⠀⠀⠀⠀⣿⠀⠀⠀⠀⠀⠀⠈⣋⣤⣤⣤⣤⣀⡉⠁⠀⠀⠀⠀⠁⠀⠀⠀⢿⡇⢀⣴⡿⠋⠁⠀⠀⠀⠀⠀⠀⠀⠀⠀⠀⠀⣿⠻⣿⣇⠀⠀⠀⠀⠀⠀⠀⠀⠀⠀⠀⠀
⠀⠀⠀⠀⠀⠀⠀⣿⠀⠀⠀⠀⠀⢠⡾⣿⣉⣑⠆⠈⠉⢻⣦⠀⠀⠀⠀⠀⠀⠀⠀⢸⣿⣿⠋⠀⠀⠀⠀⠀⠀⠀⠀⠀⠀⠀⠀⠀⠀⢸⠀⠈⢻⣧⠀⠀⠀⠀⠀⠀⠀⠀⠀⠀⠀
⠀⠀⠀⠀⠀⠀⠀⣿⠀⠀⠀⠀⠀⠘⢷⣅⡀⠀⠀⠀⣀⣼⣿⠄⠀⠀⠸⠀⠀⠀⠀⣸⣿⠃⠀⠀⠀⢠⡶⡄⠀⠀⠀⠀⣴⣶⠀⠀⠀⠈⠀⠀⠀⢻⣷⠀⠀⠀⠀⠀⠀⠀⠀⠀⠀
⠀⠀⠀⠀⠀⠀⠀⣿⠀⠀⠀⠀⠀⠀⠀⠙⠻⢿⣿⠛⠋⠑⠋⠀⠀⠀⠈⠀⠀⠀⠀⣿⠃⠀⠀⠀⠀⢸⣿⡇⠀⠀⠀⠀⣿⣿⠀⠀⠀⠀⠀⠀⠀⠀⢿⣇⠀⠀⠀⠀⠀⠀⠀⠀⠀
⠀⠀⠀⠀⠀⠀⠀⣿⠀⠀⠀⠀⠀⠀⠀⠀⠀⠀⠀⠀⠀⠀⠀⠀⠀⠀⠸⠀⠀⠀⢸⣿⠀⠀⠀⠀⠀⠸⣿⡇⠀⠀⠀⠀⢿⡿⠀⠀⠀⠀⠀⠀⠀⠀⠘⣿⠀⠀⠀⠀⠀⠀⠀⠀⠀
⠀⠀⠀⠀⠀⠀⠀⢿⡀⠀⠀⠀⠀⠀⠀⠀⠀⠀⠀⠀⠀⠀⠀⠀⠀⠀⡇⠀⠀⠀⢸⣿⠀⠀⠀⠀⠀⢀⣤⡶⠶⣶⠶⠶⣦⣀⠀⠀⠀⢸⠀⠀⠀⠀⠀⣿⡀⠀⠀⠀⠀⠀⠀⠀⠀
⠀⠀⠀⠀⠀⠀⠀⢸⡇⠀⠀⠀⠀⠀⠀⠀⠀⠀⠀⠀⠀⠀⠀⠀⠀⢸⠁⠀⠀⠀⢸⣿⠀⠀⠀⠀⠀⣿⠃⠳⠤⠚⠀⠀⠈⣿⣆⠀⠀⡏⠀⠀⠀⠀⠀⣿⡇⠀⠀⠀⠀⠀⠀⠀⠀
⠀⠀⠀⠀⠀⠀⠀⠈⣿⠀⠀⠀⠀⠀⠀⠀⠀⠀⠀⠀⠀⠀⠀⠀⢀⡇⠀⠀⠀⠀⢸⣿⠀⠀⠀⠀⠀⠙⢷⣦⣤⣤⣤⣤⣾⢿⡟⠀⢸⠁⠀⠀⠀⠀⠀⣿⣯⡀⠀⠀⠀⠀⠀⠀⠀
⠀⠀⠀⠀⠀⠀⣠⡾⣿⣠⣤⣀⣀⡀⠀⠀⠀⠀⠀⠀⠀⠀⠀⢀⡞⠀⠀⠀⠀⠀⠈⣿⠀⠀⠀⠀⠀⠀⠀⠀⠙⠛⠛⠃⠀⠁⠀⢠⡏⠀⠀⠀⠀⠀⠀⣿⣏⣻⡆⠀⠀⠀⠀⠀⠀
⠀⠀⠀⠀⢀⣰⡟⢀⣿⠋⠀⠈⠉⠙⣷⡀⠀⠀⠀⣀⠀⠀⡠⠎⢀⡀⠀⠀⠀⠀⠀⣿⡄⠀⠀⠀⠀⠀⠀⠀⠀⠀⠀⠀⠀⠀⢀⠎⠀⠀⠀⠀⠀⢀⣠⣿⡉⠛⠻⠶⣄⡀⠀⠀⠀
⠀⣀⣤⣶⣿⠟⠀⣾⠃⠀⠀⣀⣴⡾⠫⢻⡶⣶⠟⠛⣷⣾⣥⣴⠟⡟⢶⣶⠶⣤⣤⣿⡇⠀⠀⠀⠀⠀⠀⠀⠀⢀⡀⠀⠀⣠⠎⠀⢀⡀⠀⠀⣰⡿⠉⠉⠻⣦⡀⠀⠈⢿⣦⣄⠀
⢾⣯⣵⠟⠉⠀⠀⠙⠛⠶⢟⣋⡰⠁⠀⠀⠉⠳⣦⣴⡏⠀⠈⢿⣀⢀⣠⡿⠀⣠⡴⠾⠿⣦⡀⠀⠀⠀⣀⣤⠾⠛⠙⠛⠿⣦⣤⣴⡟⠛⠷⠾⠋⠛⠓⠒⢶⡾⠃⢠⣤⣤⣤⣽⡿
⠀⠘⠳⠶⢤⣤⣴⣠⣤⣴⣿⡉⢻⡄⠀⠀⠀⠀⠀⠀⠐⠂⠀⠀⠉⠹⣅⠀⠀⢿⣤⡤⠶⠞⠛⠻⢶⠾⠛⢁⠠⠠⠀⠀⠀⢠⣬⣭⣤⣀⠀⠀⠀⠀⠀⠀⠀⢀⣠⣿⡧⠴⠞⠋⠀
⠀⠀⠀⠀⠀⠈⠉⠉⠀⠀⠙⠛⠶⠷⢤⣤⣀⡀⠀⠀⠀⠀⡰⠊⠢⣀⣬⣿⣯⣀⡀⠀⠀⠀⠀⠀⣴⣤⣄⡀⢀⣀⣀⣠⣤⣼⣇⠀⢹⠙⢷⣤⡴⠶⠛⠛⠉⠉⠉⠀⠀⠀⠀⠀⠀
⠀⠀⠀⠀⠀⠀⠀⠀⠀⠀⠀⠀⠀⠀⠀⠈⠉⠙⠛⠛⠓⠚⠓⠒⠚⠛⠁⠀⠈⠉⠙⠛⢶⣶⣶⡬⠼⠧⣬⡿⠛⠉⠉⠀⠈⠈⠙⠻⣶⠶⠞⠃⠀⠀⠀⠀⠀⠀⠀⠀⠀⠀⠀⠀⠀